Willford
An Interactive Fiction by Lady Corvus
Release 1 / Serial number 180526 / Inform 7 build 6M62 (I6/v6.33 lib 6/12N) SD

Uncle's Study
The large, slightly cluttered study had a feeling of familiarity to it. Many memories of time spent with his late uncle were brought back clearly as Willford looked about at the damask-patterned wallpaper, at the heavy old furnishings, and through the dingy windows at the city below. (Exits: West)

A line of glass-fronted bookshelves made up the north wall, all of them stuffed with the many volumes that his uncle had used for his work.

The desk, a large roll-top, was pushed right up against the southern window. It appeared to be closed.

>open desk
Willford, trying for the millionth time to open the familiar desk, was frustrated by the lock. He attempted to recall where the key had been kept, but it was frustratingly absent from his memory.

>examine pigeonholes
Willford, wishing he could see through the wooden top, attempted to get a glimpse of the pigeonholes through the slats. Unfortunately, it yielded no results.

* * *

>examine desk
A very average desk. There were two drawers on the front face, and a rolling top shut over the desktop its self. 

    *** Willford is dead. RIP, sweet prince. ***

Would you like to RESTART, RESTORE a saved game, QUIT or UNDO the last command?

>open desk
It seems to be locked.

>examine drawer
Right drawer is empty.

* * *

>examine desk
A very average desk. There were two drawers on the front face, and a rolling top shut over the desktop its self. 

    *** Willford is dead. RIP, sweet prince. ***

Would you like to RESTART, RESTORE a saved game, QUIT or UNDO the last command?

>examine drawers
You can't see any such thing.

>examine drawer
Which do you mean, the right drawer or the left drawer?

>examine left drawer
In the left drawer is an ink pot.

* * *

>examine desk
A very average desk. There were two drawers on the front face, and a rolling top shut over the desktop its self. 

    *** Willford is dead. RIP, sweet prince. ***

Would you like to RESTART, RESTORE a saved game, QUIT or UNDO the last command?

>open drawers
It isn't something you can open.

>open drawer
Which do you mean, the right drawer or the left drawer?

>right drawer
Willford, though he had been through it countless times, opened the righthand drawer. Nothing had changed, for there was nothing of note in the drawer.

>open left drawer
There wasn't much in the left drawer, merely a small pot of ink. Whatever had been in there had been taken off by greedy relatives shortly after the death of that gentleman, as Willford remembered with some warmth.

* * *

>examine drawer
Which do you mean, the right drawer or the left drawer?

* * *

>examine drawers
Willford, though he would have liked to, could not examine both drawers at once.

>examine left drawer
In the left drawer is an ink pot.

A very average drawer.

* * *

>examine left drawer
A very average drawer.

>open drawer
Which do you mean, the right drawer or the left drawer?

>open left drawer
It isn't something you can open.

* * *

>examine left drawer
A very average drawer.

>open left drawer
There wasn't much in the left drawer, merely a small pot of ink. Whatever had been in there had been taken off by greedy relatives shortly after the death of that gentleman, as Willford remembered with some warmth.

>take ink pot
Taken.

* * *

>open left drawer.
That's already open.

* * *

>examine self
Looking down at himself, Willford noticed nothing out of the ordinary. Rather average in height, perhaps a bit underfed when it came to weight. Dapper as ever, however, he noted with some satisfaction.

>examine willford
You see nothing special about Willford.

* * *

>take desk
Willford, attempting to move the desk, found that it was quite a bit heavier than he had expected, and thus relinquished the effort.

>examine bookshelves
The glass panels were already open. While the rest of the family had already pored over the shelves and taken what they wanted, Willford had also looked them over briefly, though not thoroughly.

>break glass
You can't see any such thing.

* * *

>examine book shelves
You can't see any such thing.

>examine bookshelves
The glass panels were already open. While the rest of the family had already pored over the shelves and taken what they wanted, Willford had also looked them over briefly, though not thoroughly.

In Bookshelves is Books.

>examine books
Many of the books were written in German, though Willford knew there were at least five different languages up on that shelf. Somehow, Willford thought, something was a bit off. Perhaps it had to do with the rest of the family picking through them and disarranging them.

* * *

>examine bookshelves
The glass panels were already open. While the rest of the family had already pored over the shelves and taken what they wanted, Willford had also looked them over briefly, though not thoroughly. 

In Bookshelves is Books.

>examine books
Many of the books were written in German, though Willford knew there were at least five different languages up on that shelf. Somehow, Willford thought, something was a bit off. Perhaps it had to do with the rest of the family picking through them and disarranging them.

>take key
Taken.

* * *

>examine bookshelf
You can't see any such thing.

>examine bookshelves
The glass panels were already open. While the rest of the family had already pored over the shelves and taken what they wanted, Willford had also looked them over briefly, though not thoroughly.

In Bookshelves is Books.

* * *

>examine willford
Looking down at himself, Willford noticed nothing out of the ordinary. Rather average in height, perhaps a bit underfed when it came to weight. Dapper as ever, however, he noted with some satisfaction.

* * *

>read desk
A very average desk. There were two drawers on the front face, and a rolling top shut over the desktop its self.

>read book
You can't see any such thing.

>read books
Many of the books were written in German, though Willford knew there were at least five different languages up on that shelf. Somehow, Willford thought, something was a bit off. Perhaps it had to do with the rest of the family picking through them and disarranging them.

>examine shelves
The glass panels were already open. While the rest of the family had already pored over the shelves and taken what they wanted, Willford had also looked them over briefly, though not thoroughly.

In Bookshelves is Books.

>close shelves
You close Bookshelves.

>examine shelves
You see nothing special about Bookshelves.

* * *

>open drawers
Willford could not open both drawers at the same time, for the desk was too wide, and the drawer tracks a bit too sticky with age.

>open drawers
That's already open.

* * *

>open left drawer
There wasn't much in the left drawer, merely a small pot of ink. Whatever had been in there had been taken off by greedy relatives shortly after the death of that gentleman, as Willford remembered with some warmth.

>take ink bottle
I only understood you as far as wanting to take the ink pot.

>take the ink pot
Taken.

>open top
You can't see any such thing.

>open desk
Willford, trying for the millionth time to open the familiar desk, was frustrated by the lock. He attempted to recall where the key had been kept, but it was frustratingly absent from his memory.

>search bookshelves
In Bookshelves is Books.

>look out window
I only understood you as far as wanting to look outside.

>look outside
You see nothing unexpected in that direction.

>examine window
You can't see any such thing.

>examine books
Many of the books were written in German, though Willford knew there were at least five different languages up on that shelf. Somehow, Willford thought, something was a bit off. Perhaps it had to do with the rest of the family picking through them and disarranging them.

>pull book
You can't see any such thing.

>take book
You can't see any such thing.

* * *

>examine shelves
The glass panels were already open. While the rest of the family had already pored over the shelves and taken what they wanted, Willford had also looked them over briefly, though not thoroughly.

In Bookshelves is Books.

>examine books
Many of the books were written in German, though Willford knew there were at least five different languages up on that shelf. Somehow, Willford thought, something was a bit off. Perhaps it had to do with the rest of the family picking through them and disarranging them.

>take books
Taken.

* * *

>take books
Wilford wished he could take all of the books back with him, but had no means to do so at the time,

>examine desk
A very average desk. There were two drawers on the front face, and a rolling top shut over the desktop its self.

>examine drawers
Willford, though he would have liked to, could not examine both drawers at once.

>examine left drawer
A very average drawer.

>examine right drawer
A very average drawer.

>open left drawer
There wasn't much in the left drawer, merely a small pot of ink. Whatever had been in there had been taken off by greedy relatives shortly after the death of that gentleman, as Willford remembered with some warmth.

>take ink
Taken.

>open right drawer
Willford, though he had been through it countless times, opened the righthand drawer. Nothing had changed, for there was nothing of note in the drawer.

>open desk
Willford, trying for the millionth time to open the familiar desk, was frustrated by the lock. He attempted to recall where the key had been kept, but it was frustratingly absent from his memory.

>think about key
I only understood you as far as wanting to think.

>think
What a good idea.

>examine self
Looking down at himself, Willford noticed nothing out of the ordinary. Rather average in height, perhaps a bit underfed when it came to weight. Dapper as ever, however, he noted with some satisfaction.

* * *

>read books
While he would have loved nothing better than to read his uncle's entire collection, there was no possible way to do that at the moment.

>read book
You can't see any such thing.

>read self
Looking down at himself, Willford noticed nothing out of the ordinary. Rather average in height, perhaps a bit underfed when it came to weight. Dapper as ever, however, he noted with some satisfaction.

>red
That's not a verb I recognise.

>read
What do you want to read?

>think about willford
While it was tempting, Willford didn't wish to delve too deeply into philosophy at the moment.

* * *

>think about self
While it was tempting, Willford didn't wish to delve too deeply into philosophy at the moment.

>examine wallpaper
It was very familiar to him, the deep blue hue a bit faded, but still quite nice to look at.

* * *

>take off clothes
Willford found no reason to be indecent, and so did not go to the trouble of disrobing.

>examine self
Looking down at himself, Willford noticed nothing out of the ordinary. Rather average in height, perhaps a bit underfed when it came to weight. Dapper as ever, however, he noted with some satisfaction.

* * *

>take off clothes
Willford found no reason to be indecent, and so did not go to the trouble of disrobing.

>remove clothes
Willford found no reason to be indecent, and so did not go to the trouble of disrobing.

* * *

>close shelves
Wilford closed the bookshelves.

You close Bookshelves.

* * *

>close bookshelves
Wilford closed the bookshelves.

* * *

>look window
Willford glanced out the window at the city below. It was the same, dirty, grey street as it had always been, but it seemed somehow more dreary than usual.

>look out window
I only understood you as far as wanting to look outside.

* * *

>look out window
Willford glanced out the window at the city below. It was the same, dirty, grey street as it had always been, but it seemed somehow more dreary than usual.

* * *

>break glass
Violence isn't the answer to this one.

* * *

>die
Willford felt a sudden pain in his chest; he had always had a weak heart, and now it seemed it was going to kill him. It became harder and harder to breathe, his ears starting to ring and his vision going blurry. He collapsed, never to rise again.

    *** Willford has died. RIP, sweet prince. ***

Would you like to RESTART, RESTORE a saved game, QUIT or UNDO the last command?

* * *

>perish
*** Willford is dead. RIP, sweet prince. ***

Would you like to RESTART, RESTORE a saved game, QUIT or UNDO the last command?

* * *

>talk to uncle leo
That's not a verb I recognise.

* * *

>think about uncle leo
Willford took a moment to remember his eccentric uncle. He had been something of a recluse, but a brilliant scientist. Of all his upper-crust family, he only seemed to get along well with Willford himself, the other black-sheep of the family.

* * *

>look at books
Many of the books were written in German, though Willford knew there were at least five different languages up on that shelf. Somehow, Willford thought, something was a bit off. Perhaps it had to do with the rest of the family picking through them and disarranging them.

>think about books
Willford focused his thoughts on the books. Giving them a hard look, he realized that volume three of his uncle's favourite encyclopedia set was upside-down. That was very uncharacteristic of Uncle Leo, and he couldn't imagine any of his family members picking up only the third volume to look at.

>look at books
Many of the books were written in German, though Willford knew there were at least five different languages up on that shelf. Now that he had noticed the upside-down encyclopedia, he knew why it had felt a bit off.

>look at shelf
The glass panels were already open. While the rest of the family had already pored over the shelves and taken what they wanted, Willford had also looked them over briefly, though not thoroughly. 

In Bookshelves are an encyclopedia and Books.